#######
#@....#
#..#..#
#.###.#
#..#..#
#....@#
#######